%%%%%%%%%%%
%      ...%
%%%%%%%. %%
%GG P...  %
%%%%%%%%%%%
